#############
#.G...#..O..#
#.###.#.###.#
T.O...P.....T
#.#########.#
#.....G...O.#
#############