#####################
#O....G.....#...O...#
#.###.###.#.#.###.###
#.#..O..#.#.#.......#
#.#.###.#.#.#.#####.#
#...#G..#...#.#.....#
###.#.#######.#.#####
T...#....P....#.....T
#.#.#.#######.#.#####
#.#.#.#.....#.#..O..#
#.###.#.###.#.#####.#
#...O.G..#.........G#
#####################