#############################
#################........O..#
#O###.#####.###.#.###.###.#.#
#.###.#.....#...#...#.....#.#
#.###.#.###.###.###.#.###.#.#
#..P..#.#.....G.....#.#.....#
#.###.#.#.#########.#.#.###.#
#.###.#.#...........#.#.###.#
#.....#.#.###.###.###.#.....#
#####.#.#.#...GG..#.#.#.#####
#.......#.#.......#.#.......#
#.#######.#.......#.#######.#
T...........................T
#############################
